%%%%%%%%%%%%%%
%     .    % %
%          %G%
%          % %
%          % %
%          % %
%          % %
%          % %
%     P    % %
%          % %
%          % %
%          % %
%          % %
%%%%%%%%%%%%%%
