%%%%%%%%%%%%%%
% .        . %
%            %
%            %
%           P%
%%%%%%%%%%%%%%
