%%%%%%%
%.   G%
%   P %
%    G%
%%%%%%%
