%%%%%%%
%%%G%%%
%%% %%%
%%% %%%
%%%P%%%
%     %
% %%% %
% %%% %
%  .  %  
%%%G%%%	
%%%%%%%