%%%%%%%
%.    %
%    P%
%    G%
%%%%%%%
